1a
20,20
3232323232131313323232321212122532323232
3232323232131313323232321212123232323232
3215151515131313151515151515151515151532
3215151515131313151515151515151515151532
3215151515131313151515151515151515151532
3215151525131313323232321212122515151532
1315151513131313323232321212121212121212
1315151513131313323232321212121212121212
1315151513131313323232321212121212121212
3215151532323232323232323232323215151532
3215151532322532323232322532323215151525
3215151532323232323232323232323215151532
1015151510101010323232321414141414141414
1015151510101010323232321414141414141414
1015151510101010323232321414141414141414
3215151525101010323232321414142515151532
3215151515101010151515151515151515151532
3215151515101010151515151515151515151532
3215151515101010151515151515151515151532
3232323232101010323232321414142532323232
