1a
20,20
1212121212121215121212121215121212121215
1111101010101015101010101015101010101015
1111101414141011101414141011101414141015
1111101422141011101422141011101422141015
1111101414141011101414141011101414141015
1111101010101015101010101015101010101015
1111121212121222121212121222121212121215
1111101010101015101010101015101010101015
1111101414141011101414141011101414141015
1111101422141011101422141011101422141015
1111101414141011101414141011101414141015
1111101010101015101010101015101010101015
1111121212121222121212121222121212121215
1111101010101015101010101015101010101015
1111101414141011101414141011101414141015
1111101422141011101422141011101422141015
1111101414141011101414141011101414141015
1111101010101015101010101015101010101015
1313131313131313131313131313131313131313
1313131313131313131313131313131313131313
