1a
20,20
1015101510151015101513151315131513151315
1510151015101510151015131513151315131513
1015101510151015101513151315131513151315
1510151015101510151015131513151315131513
1015101510261015101513151315132613151315
1510151015101510151015131513151315131513
1015101510151023101513151323131513151315
1510151015101510151015131513151315131513
1015101510151015101524151315131513151313
1010151015101510151022131513151315131313
1022101510151015101522151315131513132213
1010151015101510151024131513151315131313
1015101510151015101513151315131513151313
1510151015101523151015131523151315131513
1015101510151015101513151315131513151315
1510151015261510151015131513152615131513
1015101510151015101513151315131513151315
1510151015101510151015131513151315131513
1015101510151015101513151315131513151315
1510151015101510151015131513151315131513
