1a
20,20
3232323232323232323232323232323232323232
3232323232323232323232323232323232323232
3232323232323232321111111111111111111111
3232323232323232321110111011101110111011
1111111111111111111110111011101110111034
3232323232323232321110111011101110111011
3232323232323232321111111111111111111111
3232323232323232323232323232323232323232
3232323232323232323232323232323232323232
3232323232323232323232323232323232323232
3232323232323232323232323232323232323232
3232323232323232323232323232323232323232
3232323232323232323232323232323232323232
3232323232323232323232323232323232323232
3232323232323232323232323232323232323232
3232323232323232323232323232323232323232
3232323232323232323232323232323232323232
3232323232323232323232323232323232323232
3232323232323232323232323232323232323232
3232323232323232323232323232323232323232
