1a
20,20
1010101010101010101010101010101010101010
1010101010101010101010101010101010101010
1010101010101010101010101010101010101010
1010101010101010101010101010101010101010
1210121010101010101010101010101010101010
1012101211101010101010101010101010101010
1212121011101010101010101010101010101010
1012101211101010131013101310131013101310
1210121011101010121010101010101010101010
1010101013131313111313131313131313131334
1210121011101010121010101010101010101010
1012101211101010131013101310131013101310
1212121011101010101010101010101010101010
1012101211101010101010101010101010101010
1210121010101010101010101010101010101010
1010101010101010101010101010101010101010
1010101010101010101010101010101010101010
1010101010101010101010101010101010101010
1010101010101010101010101010101010101010
1010101010101010101010101010101010101010
