1a
20,20
1310131013101310131013101310131013101310
1311131113111311131113111311131113111311
1013101310131013101310131013101310131013
1311131113111311131113111311131113111311
1310131013101310131013101310131013101310
1311131113111311131113111311131113111311
1013101310131013101310131013101310131013
1311131113111311131113111311131113111311
1310131013101310131013101310131013101310
1311131113111311131113111311131113111311
1013101310131013101310131013101310131013
1311131113111311131113111311131113111311
1310131013101310131013101310131013101310
1311131113111311131113111311131113111311
1013101310131013101310131013101310131013
1311131113111311131113111311131113111311
1310131013101310131013101310131013101310
1311131113111311131113111311131113111311
1310111313131313131313131313131313131313
1010101010101010101010101010101010101010
