1a
20,20
1114111411141114111411141114111411141114
1211141114111411141114111411141114111411
1111111411141114111411141114111411141114
1211121114111411141114111411141114111411
1111111111141114111411141114111411141114
1211121112111411141114111411141114111411
1111111111111114111411141114111411141114
1211121112111211141114111411141114111411
1111111111111111111411141114111411141114
1211121112111211121114111411141114111411
1111111111111111111111141114111411141114
1211121112111211121112111411141114111411
1111111111111111111111111114111411141114
1211121112111211121112111211141114111411
1111111111111111111111111111111411141114
1211121112111211121112111211121114111411
1111111111111111111111111111111111141114
1211121112111211121112111211121112111411
1111111111111111111111111111111111111114
1211121112111211121112111211121112111211
